1111101111111111111111111
1P0E000000000000000000001
10I00I0000000000000000001
1000001000000000000000001
1000001000000000000000001
1000000000000000000000001
1000001000000000000000001
1000000000000000000000001
1000000000000000000000001
1000000000000000000000001
1000001000000000000000000
1000001000000000000000001
1000000000000000000000001
1000000E00000000000000001
1000000000000000000000001
1111111111111111111111111